⬜⬜⬜⬜⬜⬜⬜⬛⬛⬛⬛🔲⬛⬛⬛⬜
⬜⬜⬜⬜⬜⬛⬛⬛⬛⬛⬛⬛⬜⬜⬜⬛
⬜⬜⬜⬜⬛⬛⬛⬛⬛⬛⬛⬛⬜⬜⬜⬛
⬜⬜⬜⬛⬛🔳⬛⬛⬛⬛⬛⬛⬛⬜⬜⬛
⬜⬜⬛⬛⬛⬛⬛⬛⬛⬛⬛⬛⬛⬛🔲⬛
⬜⬜⬛⬛⬛⬛⬜⬜⬜⬜⬜⬜⬛⬛⬛⬜
⬜⬛⬛⬛⬛⬜⬜⬜⬛⬜⬛⬜⬛⬛⬛⬛
⬜⬛🔲⬛⬛⬜⬜⬜⬛⬜⬛⬜⬛⬛⬛⬛
⬛⬜⬜⬛⬛⬛⬜⬜⬜⬜⬜⬜⬜⬛⬛⬛
⬛⬜⬜⬜⬛⬜⬜⬛⬜⬜⬜⬜⬜⬛⬛⬛
⬜🔳⬜⬜⬜⬜⬛⬛⬛⬛⬜⬜⬛⬛⬛⬜
⬜⬜⬛⬛⬜⬜⬜⬜⬛⬛⬛⬛⬛⬛⬛⬜
⬜⬜⬜⬛⬛⬛⬜⬜⬜⬜🔲⬛⬛⬛⬛⬜
⬜⬜⬛⬛⬛⬛⬛⬛⬛⬛⬛⬛⬛⬛⬜⬜
⬜⬛⬛🔳⬛⬛⬛⬛⬛⬛⬛⬛⬛⬜⬜⬜
⬛⬛🔳⬛⬛⬛⬛⬛⬛⬛🔳⬛⬛⬛⬜⬜
⬛⬛⬛⬛⬜⬜⬜⬛⬛⬛⬛⬛⬛⬛⬜⬜
⬛⬛⬛⬜⬜⬜⬜⬜⬛🔳⬛⬛⬛⬛⬛⬜
⬜⬛⬛⬜⬜⬜⬜⬜⬛⬜⬜🔳🔳⬛⬛⬜
⬜⬜⬛⬛⬜⬜⬜⬛🔳⬜⬜🔳⬛🔳🔳⬛
⬜⬛🔳🔳⬛⬛⬛🔳🔳🔳🔳⬛🔳🔳🔳⬛
⬛⬛🔳⬛🔳🔳🔳🔳🔳🔳🔳⬛🔳🔳🔳⬛
⬛🔳🔳⬛🔳🔳🔳🔳⬛⬛⬛⬛🔳🔳🔳⬛
⬛🔳🔳⬛🔳⬛⬛⬛⬜⬜⬜⬛🔳🔳⬛⬛
⬛🔳🔳⬛⬛⬜⬜⬜⬜⬜⬜⬜⬛⬛⬛⬜
⬜⬛⬛⬜⬜⬜⬜⬜⬜⬜⬜⬜⬜⬜⬜⬜