⬜⬜⬜⬜⬜⬜⬜⬜⬜⬜⬜⬜⬜⬜⬜⬜⬜⬜⬜⬜⬜⬜⬜⬜⬜⬜⬜⬜⬜⬜
⬜⬜⬜⬜⬜⬜⬜⬜⬜⬜⬜⬜⬛⬛⬛⬛⬛⬛⬛⬜⬜⬜⬜⬜⬜⬜⬜⬜⬜⬜
⬜⬜⬜⬜⬜⬜⬜⬜⬜⬜⬛⬛⬛⬛⬛⬛⬛⬛⬛⬛⬛⬛⬜⬜⬜⬜⬜⬜⬜⬜
⬜⬜⬜⬜⬜⬜⬜⬜⬛⬛⬛⬜⬜⬛⬛⬛⬛⬛⬛⬛⬛⬛⬛⬜⬜⬜⬜⬜⬜⬜
⬜⬜⬜⬜⬜⬜⬜⬛⬛⬜⬜⬜⬛⬛⬛⬛⬛⬛⬛⬛⬛⬛⬛⬛⬜⬜⬜⬜⬜⬜
⬜⬜⬜⬜⬜⬜⬛⬛⬜⬜⬜⬜⬛⬛⬛⬛⬛⬛⬛⬛⬛⬛⬛⬛⬛⬜⬜⬜⬜⬜
⬜⬜⬜⬜⬜⬛⬛⬜⬜⬜⬜⬛⬛⬛⬜⬜⬜⬛⬛⬛⬛⬛⬛⬛⬛⬛⬜⬜⬜⬜
⬜⬜⬜⬜⬜⬛⬛⬜⬜⬜⬜⬛⬛⬛⬜⬜⬜⬛⬛⬛⬛⬛⬛⬛⬛⬛⬛⬜⬜⬜
⬜⬜⬜⬜⬛⬛⬜⬜⬜⬜⬜⬛⬛⬛⬜⬜⬜⬛⬛⬛⬛⬛⬛⬛⬛⬛⬛⬜⬜⬜
⬜⬜⬜⬜⬛⬛⬜⬜⬜⬜⬜⬛⬛⬛⬛⬛⬛⬛⬛⬛⬛⬛⬛⬛⬛⬛⬛⬜⬜⬜
⬜⬜⬜⬜⬛⬜⬜⬜⬜⬜⬜⬜⬛⬛⬛⬛⬛⬛⬛⬛⬛⬛⬛⬛⬛⬛⬛⬛⬜⬜
⬜⬜⬜⬛⬛⬜⬜⬜⬜⬜⬜⬜⬜⬛⬛⬛⬛⬛⬛⬛⬛⬛⬛⬛⬛⬛⬛⬛⬜⬜
⬜⬜⬜⬛⬛⬜⬜⬜⬜⬜⬜⬜⬜⬜⬛⬛⬛⬛⬛⬛⬛⬛⬛⬛⬛⬛⬛⬛⬜⬜
⬜⬜⬜⬛⬛⬜⬜⬜⬜⬜⬜⬜⬜⬜⬜⬜⬜⬛⬛⬛⬛⬛⬛⬛⬛⬛⬛⬛⬜⬜
⬜⬜⬜⬛⬛⬜⬜⬜⬜⬜⬜⬜⬜⬜⬜⬜⬜⬜⬜⬛⬛⬛⬛⬛⬛⬛⬛⬛⬜⬜
⬜⬜⬜⬜⬛⬜⬜⬜⬜⬜⬜⬜⬜⬜⬜⬜⬜⬜⬜⬜⬛⬛⬛⬛⬛⬛⬛⬛⬜⬜
⬜⬜⬜⬜⬛⬛⬜⬜⬜⬜⬜⬜⬜⬜⬜⬜⬜⬜⬜⬜⬜⬛⬛⬛⬛⬛⬛⬜⬜⬜
⬜⬜⬜⬜⬛⬛⬜⬜⬜⬜⬜⬜⬜⬜⬛⬛⬛⬜⬜⬜⬜⬛⬛⬛⬛⬛⬛⬜⬜⬜
⬜⬜⬜⬜⬜⬛⬛⬜⬜⬜⬜⬜⬜⬜⬛⬛⬛⬜⬜⬜⬜⬛⬛⬛⬛⬛⬜⬜⬜⬜
⬜⬜⬜⬜⬜⬛⬛⬜⬜⬜⬜⬜⬜⬜⬛⬛⬛⬜⬜⬜⬜⬛⬛⬛⬛⬛⬜⬜⬜⬜
⬜⬜⬜⬜⬜⬜⬛⬛⬜⬜⬜⬜⬜⬜⬜⬜⬜⬜⬜⬜⬜⬛⬛⬛⬛⬜⬜⬜⬜⬜
⬜⬜⬜⬜⬜⬜⬜⬛⬛⬜⬜⬜⬜⬜⬜⬜⬜⬜⬜⬜⬛⬛⬛⬛⬜⬜⬜⬜⬜⬜
⬜⬜⬜⬜⬜⬜⬜⬜⬛⬛⬛⬜⬜⬜⬜⬜⬜⬜⬜⬛⬛⬛⬛⬜⬜⬜⬜⬜⬜⬜
⬜⬜⬜⬜⬜⬜⬜⬜⬜⬜⬛⬛⬛⬛⬛⬛⬛⬛⬛⬛⬛⬜⬜⬜⬜⬜⬜⬜⬜⬜
⬜⬜⬜⬜⬜⬜⬜⬜⬜⬜⬜⬜⬛⬛⬛⬛⬛⬛⬛⬜⬜⬜⬜⬜⬜⬜⬜⬜⬜⬜
⬜⬜⬜⬜⬜⬜⬜⬜⬜⬜⬜⬜⬜⬜⬜⬜⬜⬜⬜⬜⬜⬜⬜⬜⬜⬜⬜⬜⬜⬜