⬛⬛⬛⬛⬛⬛⬛⬛⬛⬛⬛⬛⬛
⬛🟥⬛⬛⬛🟥⬛⬛🟥🟥🟥⬛⬛
⬛🟥🟥⬛⬛🟥⬛🟥⬛⬛⬛🟥⬛
⬛🟥⬛🟥⬛🟥⬛🟥⬛⬛⬛🟥⬛
⬛🟥⬛⬛🟥🟥⬛🟥⬛⬛⬛🟥⬛
⬛🟥⬛⬛⬛🟥⬛⬛🟥🟥🟥⬛⬛
⬛⬛⬛⬛⬛⬛⬛⬛⬛⬛⬛⬛⬛