⬜⬜⬜⬜⬜⬜⬜⬜⬜⬜⬜⬜⬜⬜⬜⬜⬜⬜⬜⬜⬜
⬜⬜⬜⬛⬛⬛⬜⬜⬜⬜⬜⬜⬜⬜⬛⬛⬛⬜⬜⬜⬜
⬜⬜⬛🟨🟨🟨⬛⬜⬜⬜⬜⬜⬜⬛🟨🟨🟨⬛⬜⬜⬜
⬜⬛🟨🟨🟨⬛🟨⬛⬜⬜⬜⬜⬛🟨⬛🟨🟨🟨⬛⬜⬜
⬜⬛🟨🟨🟨⬛⬛⬛⬛⬛⬛⬛⬛⬛⬛🟨🟨🟨⬛⬜⬜
⬜⬜⬛⬛⬛⬛⬜⬜⬜⬜🟨🟨🟨🟨⬛⬛⬛⬛⬜⬜⬜
⬜⬜⬜⬜⬛⬜⬜⬜⬜⬜⬜🟨🟨🟨🟨⬛⬜⬜⬜⬜⬜
⬜⬜⬜⬜⬛⬜⬜⬜⬜⬜⬜🟨🟨🟨🟨⬛⬜⬜⬜⬜⬜
⬜⬜⬜⬜⬛⬜⬜⬜⬜⬜⬜🟨🟨🟨🟨⬛⬜⬜⬜⬜⬜
⬜⬜⬜⬜⬛⬜⬜⬛⬜⬜⬜⬛⬜🟨🟨⬛⬜⬜⬜⬜⬜
⬜⬜⬜⬜⬛⬜⬜⬛⬛⬜⬜⬛⬛🟨🟨⬛⬜⬜⬜⬜⬜
⬜⬜⬜⬜⬛⬜⬜⬜⬜⬜⬜⬜🟨🟨🟨⬛⬜⬜⬜⬜⬜
⬜⬜⬜⬛⬜⬜⬜⬛⬛⬛⬛⬛⬛⬜🟨🟨⬛⬜⬜⬜⬜
⬜⬜⬜⬛⬜⬜⬜⬛⬛⬛⬛⬛⬛⬜⬜⬜⬛⬜⬜⬜⬜
⬜⬜⬜⬛⬜⬜⬜⬜⬛⬛⬛⬛⬜⬜⬜⬜⬛⬜⬜⬜⬜
⬜⬜⬜⬛⬜⬜⬜⬜⬜⬜⬜⬜⬜⬛⬜⬜⬛⬜⬜⬜⬜
⬜⬜⬜⬜⬛⬜⬜⬛⬛⬛⬛⬛⬛⬜⬜⬛⬜⬜⬜⬜⬜
⬜⬜⬜⬜⬜⬛⬜⬜⬜⬜⬜⬜⬜⬜⬛⬜⬜⬜⬜⬜⬜
⬜⬜⬜⬜⬜⬜⬛🟥🟥🟨🟨🟥🟥⬛⬜⬜⬜⬜⬜⬜⬜
⬜⬜⬜⬜⬜⬛⬜⬜🟨🟨🟨🟨⬜⬜⬛⬜⬜⬜⬜⬜⬜
⬜⬜⬜⬜⬜⬛⬜⬜🟨🟨🟨🟨⬜⬜⬛⬜⬜⬜⬛⬜⬜
⬜⬜⬜⬜⬜⬛⬜⬜⬜⬜⬜⬜⬜⬜⬛⬜⬜⬛⬜⬛⬜
⬜⬜⬜⬜⬛⬜⬜⬜⬜⬜⬜⬜⬜⬜⬜⬛⬜⬛⬜⬛⬜
⬜⬜⬜⬛⬜⬜⬜⬜⬜⬛⬜⬛⬜⬜⬜⬜⬛⬛⬜⬛⬜
⬜⬜⬜⬛⬜⬜⬛⬜⬜⬛⬜⬛⬜⬜⬛⬜⬛⬜⬜⬛⬜
⬜⬜⬛⬜⬛⬜⬛⬜⬜⬛⬜⬛⬜⬜⬛⬜⬛⬜⬛⬛⬜
🟩🟩⬛⬜⬜⬛⬛⬜⬜⬛⬛⬛⬜⬜⬛⬛⬜⬛⬛🟩🟩
🟩🟩🟩⬛⬛🟩🟩⬛⬛🟩🟩🟩⬛⬛🟩🟩⬛⬛🟩🟩🟩
🟩🟩🟩🟩🟩🟩🟩🟩🟩🟩🟩🟩🟩🟩🟩🟩🟩🟩🟩🟩🟩