⬜⬜⬜⬜⬜⬜⬜⬜⬛⬛⬛⬛⬜⬛⬛⬛⬜⬜
⬜⬜⬜⬜⬜⬜⬛⬛🟥🟥🟥⬛⬛🟨🟨🟨⬛⬜
⬜⬜⬜⬜⬜⬛🟥🟥🟥🟥🟥🟥⬛🟨🟨🟨⬛⬜
⬜⬜⬜⬜⬛🟥🟥🟥⬛⬛⬛⬛⬛⬛🟨🟨⬛⬜
⬜⬜⬜⬛🟥🟥🟥⬛⬛⬛⬛⬛⬛⬛⬛🟨⬛⬜
⬜⬜⬜⬛🟥⬛⬛🟨🟨🟨🟨🟨🟨⬛⬛⬛⬜⬜
⬜⬜⬛⬛⬛⬛🟨🟨🟨⬛🟨⬛🟨⬛🟥🟥⬛⬜
⬜⬜⬛🟨⬛⬛🟨🟨🟨⬛🟨⬛🟨⬛🟥🟥⬛⬜
⬜⬛🟨🟨⬛⬛⬛🟨🟨🟨🟨🟨🟨🟨⬛🟥⬛⬜
⬜⬛🟨🟨🟨⬛🟨🟨⬛🟨🟨🟨🟨🟨⬛🟥⬛⬜
⬜⬜⬛🟨🟨🟨🟨⬛⬛⬛⬛🟨🟨⬛⬛⬛⬜⬜
⬜⬜⬜⬛⬛🟨🟨🟨🟨⬛⬛⬛⬛⬛🟥⬛⬜⬜
⬜⬜⬜⬜⬛⬛⬛🟨🟨🟨🟨🟨⬛🟥🟥⬛⬜⬜
⬜⬜⬜⬛🟥🟥🟥⬛⬛⬛⬛⬛⬛🟥⬛⬜⬜⬜
⬜⬜⬛🟥🟥🟥🟥🟥⬛⬛🟥🟥⬛⬛⬜⬜⬜⬜
⬜⬛🟥🟥🟥⬛⬛⬛🟦⬛🟥🟥🟥⬛⬛⬜⬜⬜
⬜⬛🟥🟥⬛🟨🟨🟨⬛🟦⬛🟥🟥🟥⬛⬜⬜⬜
⬜⬛🟥⬛🟨🟨🟨🟨🟨⬛🟦⬛⬛⬛⬛⬛⬜⬜
⬜⬜⬛⬛🟨🟨🟨🟨🟨⬛⬜⬜🟦🟦⬛⬛⬜⬜
⬜⬜⬜⬛⬛🟨🟨🟨⬛🟦⬜⬜🟦⬛🟥🟥⬛⬜
⬜⬜⬛🟥🟥⬛⬛⬛🟦🟦🟦🟦⬛🟥🟥🟥⬛⬜
⬜⬛⬛🟥⬛🟦🟦🟦🟦🟦🟦🟦⬛🟥🟥🟥⬛⬜
⬜⬛🟥🟥⬛🟦🟦🟦🟦⬛⬛⬛⬛🟥🟥🟥⬛⬜
⬜⬛🟥🟥⬛🟦⬛⬛⬛⬜⬜⬜⬛🟥🟥⬛⬛⬜
⬜⬛🟥🟥⬛⬛⬜⬜⬜⬜⬜⬜⬜⬛⬛⬛⬜⬜
⬜⬜⬛⬛⬜⬜⬜⬜⬜⬜⬜⬜⬜⬜⬜⬜⬜⬜
