⬜⬜⬜⬜⬜⬜⬜⬜⬜⬜⬜⬜⬜⬜⬜⬜⬜⬜⬜⬜
⬜⬜⬜⬜⬜⬜⬜⬛⬛⬛⬛⬛⬜⬜⬜⬜⬜⬜⬜⬜
⬜⬜⬜⬜⬜⬛⬛⬛⬛⬛⬛⬛⬛⬛⬜⬜⬜⬜⬜⬜
⬜⬜⬜⬜⬛⬛⬛⬛⬛⬛⬛⬛⬛⬛⬛⬜⬜⬜⬜⬜
⬜⬜⬜⬛⬛⬛⬛⬛⬛⬛⬛⬛⬛⬛⬛⬛⬜⬜⬜⬜
⬜⬜⬜⬛⬛⬜⬜⬜⬛⬛⬛⬜⬜⬜⬛⬛⬜⬜⬜⬜
⬜⬜⬛⬛⬜⬜⬜⬜⬜⬛⬜⬜⬜⬜⬜⬛⬛⬜⬜⬜
⬜⬛⬛⬛⬜⬜⬜⬜⬜⬜⬜⬜⬜⬜⬜⬛⬛⬛⬜⬜
⬜⬛⬛⬜⬜⬜⬜⬛⬜⬜⬜⬛⬜⬜⬜⬜⬛⬛⬜⬜
⬜⬛⬛⬜⬜⬜⬛⬛⬜⬜⬜⬛⬛⬜⬜⬜⬛⬛⬜⬜
⬜⬛⬛⬜⬜⬜⬛⬛⬜⬜⬜⬛⬛⬜⬜⬜⬛⬛⬜⬜
⬜⬛⬛⬜⬜⬜⬜⬛⬜⬜⬜⬛⬜⬜⬜⬜⬛⬛⬜⬜
⬜⬛⬛⬜⬜⬜⬜🟨🟥🟨🟥🟨⬜⬜⬜⬜⬛⬛⬜⬜
⬜⬜⬛⬛⬜⬜🟥🟨🟨🟨🟨🟨🟥⬜⬜⬛⬛⬜⬜⬜
⬜⬜⬛⬛⬛⬛⬜🟥🟨🟨🟨🟥⬜⬜⬛⬛⬛⬜⬜⬜
⬜⬜⬜⬛🟦🟦⬛⬜🟥🟥🟥⬜⬛⬛⬛🟦⬜⬜🟦⬜
⬜⬜⬜⬜🟦🟦🟦🟦🟦🟦🟦🟦🟦🟦🟦🟦⬜🟦🟦⬜
⬜⬜⬜⬛🟦🟦🟦🟦🟦🟦🟦🟦🟦🟦🟦🟦🟦🟦⬜⬜
⬜⬜⬜⬛⬛🟦🟦🟦🟦🟦🟦🟦🟦🟦🟦🟦🟦⬜⬜⬜
⬜⬜⬜⬛⬛⬛⬛⬜⬜⬜⬜⬜⬜⬛⬛🟦🟦⬜⬜⬜
⬜⬜⬜⬛⬛⬜⬜⬜⬜⬜⬜⬜⬜⬜⬛⬛⬜⬜⬜⬜
⬜⬜⬛⬛⬛⬜⬜⬜⬜⬜⬜⬜⬜⬜⬛⬛⬛⬜⬜⬜
⬜⬜⬛⬛🟥🟥🟥⬜⬜⬜⬜⬜⬜🟥🟥🟥⬛⬜⬜⬜
⬜⬜⬛⬛🟥🟨🟨⬜⬜⬜⬜⬜🟨🟨🟨🟥⬛⬜⬜⬜
⬜⬜⬛⬛🟥🟨🟨🟨⬜⬜⬜⬜🟨🟨🟨🟥⬛⬜⬜⬜
⬜⬜⬛🟥🟨🟨🟨🟨⬜⬜⬜⬜🟨🟨🟨🟨🟨⬜⬜⬜
⬜⬜⬜🟨🟨🟨🟨🟨⬜⬜⬜🟨🟨🟨🟨🟨🟨⬜⬜⬜
⬜⬜⬜⬜🟥🟨🟨🟥⬛⬛⬛🟥🟨🟨🟨🟨🟨⬜⬜⬜
⬜⬜⬜⬜⬜🟥🟥⬜⬜⬜⬜⬜⬜🟥🟥⬜⬜⬜⬜⬜
⬜⬜⬜⬜⬜⬜⬜⬜⬜⬜⬜⬜⬜⬜⬜⬜⬜⬜⬜⬜